5 7
. . . . w . .
. . . . w . .
. . . . w . .
. . . . w . .
. . . . . . .


1 0
4 3
10 10
. w . . . w . . . .
. w . w . w . w w .
. w . w . w . w . .
. w . w . w . w . w
. w . w . w . w . .
. w . w . w . w w .
. w . w . w . w . .
. w . w . w . w . w
. w . w . w . w . .
. . . w . . . w w .
0 0
9 9

