10 10

. . . . w . . . . .
. . . . w . . . . .
. . . . w . . . . .
. . . . w . . . w .
. . . . . . w . . .
. . . . w . . . w .
. . . . w w w . . .
. . . . w . . . . .
. . . . w . . w . .
. . . . w . . . . .


4 1


9 7

